#4
grass.jpg, 0
dotTest.png, 1
dirt.jpg, 2
grass2.png, 3

(12,12)
012012012023
0 0 0 1 1 0 0 1 2 0 2 3
0 0 1 1 1 1 0 1 2 0 2 3
0 1 1 1 1 1 1 1 2 0 2 3
1 1 1 1 1 1 1 1 2 0 2 3
1 2 1 2 1 2 1 1 2 0 2 3
1 1 1 1 1 1 1 1 2 0 2 3
1 1 1 2 1 2 1 1 2 0 2 3
1 0 0 0 0 0 1 1 2 0 2 3
1 0 0 0 0 0 1 1 2 0 2 3
1 0 0 0 0 0 1 1 2 0 2 3
1 1 1 1 1 1 1 1 2 0 2 3