#5
dirt.tga, 0
grass.tga, 1
tallGrass.tga, 2
rock.tga, 3
water.tga, 4

(7,12)
1 0 0 0 0 0 0
0 0 0 1 1 0 0
0 0 1 1 1 1 0
0 1 1 1 1 1 1
1 1 1 1 1 1 1
1 2 1 2 1 2 1
1 1 1 1 1 1 1
1 3 1 3 1 3 1
1 0 1 0 1 0 1
1 0 4 4 4 0 1
1 0 4 4 4 0 1
1 1 1 1 1 1 1
 
