#4
grass.jpg, 0
dotTest.png, 1
dirt.jpg, 2
grass2.png, 3

(13,13)
2 2 0 1 2 0 1 1 2 0 2 3 3
1 2 0 1 2 0 1 1 2 0 2 3 3
0 2 0 1 2 0 1 1 2 0 2 3 3
2 2 0 1 2 0 1 1 2 0 2 3 3
1 2 0 1 2 0 1 1 2 0 2 3 3
0 2 0 1 2 0 1 1 2 0 2 3 3
1 2 0 1 2 0 1 1 2 0 2 3 3
2 2 0 1 2 0 1 1 2 0 2 3 3
1 2 0 1 2 0 1 1 2 0 2 3 3
0 2 0 1 2 0 1 1 2 0 2 3 3
2 2 0 1 2 0 1 1 2 0 2 3 3
1 2 0 1 2 0 1 1 2 0 2 3 3
1 2 0 1 2 0 1 1 2 0 2 3 3
 
