#
grass2.png, 0
dotTest.png, 1
bush1.png, 2
grass.jpg, 3
dirt.jpg, 4
player.png, 5

(20,200)
5 0 2 2 0 0 0 0 0 0 0 0 0 0 0 0 2 2 0 0
0 0 2 2 0 0 0 0 0 0 0 0 0 0 0 0 2 2 0 0
0 0 2 2 0 0 0 0 0 0 0 0 0 0 0 0 2 2 0 0
0 0 2 2 0 0 0 0 0 0 0 0 0 0 0 0 2 2 0 0
0 0 2 2 0 0 0 0 0 0 0 0 0 0 0 0 2 2 0 0
0 0 2 2 0 0 0 0 0 0 0 0 0 0 0 0 2 2 0 0
0 0 2 2 0 0 0 0 0 0 0 0 0 0 0 0 2 2 0 0
0 0 2 2 0 0 0 0 0 0 0 0 0 0 0 0 2 2 0 0
0 0 2 2 0 0 0 0 0 0 0 0 0 0 0 0 2 2 0 0
0 0 2 2 0 0 0 0 0 0 0 0 0 0 0 0 2 2 0 0
0 0 2 2 0 0 0 0 0 0 0 0 0 0 0 0 2 2 0 0
0 0 2 2 0 0 0 0 0 0 0 0 0 0 0 0 2 2 0 0
0 0 2 2 0 0 0 0 0 0 0 0 0 0 0 0 2 2 0 0
0 0 2 2 0 0 0 0 0 0 0 0 0 0 0 0 2 2 0 0
0 0 2 2 0 0 0 0 0 0 0 0 0 0 0 0 2 2 0 0
0 0 2 2 0 0 0 0 0 0 0 0 0 0 0 0 2 2 0 0
0 0 2 2 0 0 0 0 0 0 0 0 0 0 0 0 2 2 0 0
0 0 2 2 0 0 0 0 0 0 0 0 0 0 0 0 2 2 0 0
0 0 2 2 0 0 0 0 0 0 0 0 0 0 0 0 2 2 0 0
0 0 2 2 0 0 0 0 0 0 0 0 0 0 0 0 2 2 0 0
0 0 2 2 0 0 0 0 0 0 0 0 0 0 0 0 2 2 0 0
0 0 2 2 0 0 0 0 0 0 0 0 0 0 0 0 2 2 0 0
0 0 2 2 0 0 0 0 0 0 0 0 0 0 0 0 2 2 0 0
0 0 2 2 0 0 0 0 0 0 0 0 0 0 0 0 2 2 0 0
0 0 2 2 0 0 0 0 0 0 0 0 0 0 0 0 2 2 0 0
0 0 2 2 0 0 0 0 0 0 0 0 0 0 0 0 2 2 0 0
0 0 2 2 0 0 0 0 0 0 0 0 0 0 0 0 2 2 0 0
0 0 2 2 0 0 0 0 0 0 0 0 0 0 0 0 2 2 0 0
0 0 2 2 0 0 0 0 0 0 0 0 0 0 0 0 2 2 0 0
0 0 2 2 0 0 0 0 0 0 0 0 0 0 0 0 2 2 0 0
0 0 2 2 0 0 0 0 0 0 0 0 0 0 0 0 2 2 0 0
0 0 2 2 0 0 0 0 0 0 0 0 0 0 0 0 2 2 0 0
0 0 2 2 0 0 0 0 0 0 0 0 0 0 0 0 2 2 0 0
0 0 2 2 0 0 0 0 0 0 0 0 0 0 0 0 2 2 0 5

 
