#3
grass.jpg, 0
dirt.jpg, 1
grass2.png, 2


(10,12)
0 1 2 0 1 2 0 1 2 0
0 0 0 1 1 0 0 1 2 0
0 0 1 1 1 1 0 1 2 0
0 1 1 1 1 1 1 1 2 0
1 1 1 1 1 1 1 1 2 0
1 2 1 2 1 2 1 1 2 0
1 1 1 1 1 1 1 1 2 0
1 1 1 2 1 2 1 1 2 0
1 0 0 0 0 0 1 1 2 0
1 0 0 0 0 0 1 1 2 0
1 0 0 0 0 0 1 1 2 0
1 1 1 1 1 1 1 1 2 0
 
